аңкау - благоухать, издавать
аңлау - понимать, понять
аңсыз - несообразительный, непонятливый
аңышу - уразуметь, опомниться
абага - папоротник
абзар - хлев, стойло
абзый - уважительное, обращение
абруй - честь, авторитет
абунә - абонемент
абхаз - абхазец, абхазский
абыну - спотыкаться, споткнуться
аванс - авансовый
аврал - авральный
авыру - болезнь, заболевание
авышу - клониться, наклониться
агару - белеть, побелеть
аграр - аграрный
агулы - ядовитый, ядоносный
агызу - лить, наливать
агылу - течь, сыпаться
адәми - человеческий
адашу - заблудиться
адрес - адрес
аерма - различие, разница
аерту - пропускать
аерча - развилина, развилка
аерым - отдельный, раздельный
азгын - избалованный, безнравственный
азлап - помоленьку
азлык - недостаточность, недостаток
азман - бастард, помесь
азрак - маловато
азыну - озорничать, безобразничать
айгыр - жеребец, жеребцовый
айкау - махать, махнуть
айлап - около, месяца
айлык - ежемесячный
айнык - трезвый
айсыз - безлунный
айчык - узор на орнаменте
акбүз - миткаль, миткалевый
акбур - меловой, мелок
аккүз - белоглазка, птица
аккош - лебедь, лебединый
аклан - поляна, прогалина
аклау - выбелить, вымазать
аклык - белизна
акрын - медленный, тихий
аксак - хромой, хромоногий
аксау - хрометь, охрометь
аксыл - беловатый, белёсый
аксым - белок, белки
актүш - белобрюшка, птица
актык - последний, крайний
акула - акула, акулий
акшар - белила, меловой
акыру - орать, горланить
алама - худой, старый
алача - пестрядь, пестрядина
алаша - мерин
албан - албанский
алгыр - шустрый, юркий
алдак - обман
алдан - спереди, впереди
алдар - алдакчы
алдау - обманывать, обмануть
алдын - алдынгы
алиһә - богиня
алкын - полноводный, стремительный
алкыш - аплодисменты, овация
алмаз - алмазный
алман - немецкий
алмаш - смена, замена
алпан - тилп?н-вперевалку
алтау - шестеро, вшестером
алтын - золотой, золотой
алучы - получатель
алыну - страд, вызваться
алыча - әлүчә
алышу - алмашу, схватываться
амбар - житница
амеба - амёба
аморф - аморфный
андыз - девясил
андый - такой
анкет - анкетный
аннан - оттуда, затем
ансат - лёгкий, нетрудный
ансыз - неё, этого
антик - античный
антлы - клятвенный
аныкы - его
анысы - конечно
апара - опара, пойло
арада - пока, время
аракы - водка, водочный
арата - поперечина, перекладина
арзан - дешёвый, недорогой
аркан - аркан, канат
аркау - уток//, уточный
арлар - удмурты
армас - неутомимый, неустанный
армия - армейский
армут - груша
армый - неутомимый
артка - назад
арткы - задний, последний
артта - позади, сзади
артык - слишком, очень
артым - увеличение, привес
артыш - можжевельник, можжевёловый
архей - архейский
архив - архивный
арчан - вереск
аршын - аршин
аръяк - сторона, противоположная
арыту - ардыру
асалы - узорчатый, закладными
аслам - заклад, залог
аслык - подставка, поддон
аспид - аспидный
асрау - держать, содержать
астан - снизу, исподнизу
астар - подкладка, подшивка
асылы - хорошее
аталу - называться, назваться
атама - название, наименование
аткый - свинчатка
атлам - поступь, походка
атлап - шагом
атлас - атласный
атлау - пахтать, масло
атсыз - безымянный
атучы - стрелок
атылу - выстрелить, произвольно
атыну - качаться, покачиваться
атышу - перестрелка
аулак - укромный, безлюдный
аулау - охотиться, поохотиться
аунау - валяться, проваляться
афган - афганский
ахмак - глупый, бестолковый
ахшам - молитва, совершаемая
ачкыч - замочный, гаечный
ачлай - голодный
ачлык - голод, голодовка
ачулы - гневный, злой
ачучы - открытый
ачыгу - проголодаться, захотеть
ачылу - страд, открываться
ачыну - горевать, печалиться
ачыту - саднить, жечь
ашалу - размыв
ашату - кормить, покормить
ашкын - стремительный
ашлау - удобрять, удобрить
ашлык - хлеб, хлеба
ашыгу - торопиться, поторопиться
ашыру - претворять, претворить
аэроб - аэробный
аяклы - ножками, зеркало
аякчу - онучи, портянки
аяныч - жалкий, скорбный
аярга - щадить
әүвәл - раньше, прежде
әүлия - святой, угодник
әгъза - член, орган
әдәби - литературный
әдрәс - адрас, бухарская
әйбәт - хороший, хорошо
әйбер - вещь, предмет
әйдүк - пожалуйте, добро
әйдәү - брать, собой
әйрән - айран, напиток
әйтик - вводн, скажем
әкият - сказка, сказочный
әкрен - акрын
әлүчә - алыча, дерево
әлегә - пока, покамест
әлеге - теперешний, настоящий
әнкәй - мама, мамочка
әнчек - дворняжка
әрәтә - сотов
әрләү - бранить, побранить
әрлән - хомяк, хомячий
әрләш - перепалка, перебранка
әрмәк - армяк, армячный
әрмән - армянин, армянский
әрсез - беззастенчивый, пронырливый
әртил - артель
әсәрү - удивляться, удивиться
әсбап - прибор, приспособление
әткәй - папенька, папочка
әтрәк - драный, обтрёпаный
әтраф - сторона, окружность
әфсен - заклинание, волшебство
әфьюн - опий, опиум
әхлак - нравственность, мораль
әчетү - ачыту
әшәке - плохой, дрянной
бүген - сегодня, ныне
бүкән - чурбан, тумба
бүксә - птиц
бүләк - подарок, подарочный
бүлек - отдел, часть
бүлем - часть, отдел
бүлмә - комната, кабинет
бүрек - шапка, папаха
бүртү - набухать, набухнуть
бүсәү - разваливать, развалить
бүсер - грыжа, грыжевой
бүтән - другой, иной
бәбәк - молодая, ветвь
бәбкә - гусёнок, утёнок
бәвел - моча
бәдән - тело, телосложение
бәйге - скачки, сабантуе
бәйле - завязанный, привязанный
бәкәл - беда, злоключение
бәлҗә - пазник, поперечный
бәләк - валёк, бельевой
бәлеш - бэлеш, нацииональное
бәлки - вводн, возможно
бәндә - человек, человечек
бәпкә - баабка, снрпы
бәрән - ягнёнок, барашек
бәсле - заиндевелый, покрытый
бәхәс - спор, полемика
бәхет - счастье, удел
бәхил - предик, прощаю
бәяле - оценённый, дорогой
бөҗәк - насекомое
бөдрә - кудрявый, курчавый
бөкре - кривой, горбатый
бөреш - пешня
бөркү - прыскать, прыснуть
бөрмә - оборка, сборка
бөтәю - становиться, стать
бөтен - целый, цельный
бабай - дедушка, тесть
бавыр - печень, печёнка
базар - базар, рынок
базык - коренастый, крепкий
бакра - куколь, сорняк
бакча - садовый
бакчы - смотри-ка
бакыр - медный, медяк
балак - штанина
балан - калина
балку - сиять, светить
баллы - медолвый, сладкий
балта - топор
балык - рыбий, рыбный
барсы - все, каждая вещь
барча - весь
барыш - процесс, течение
басма - ступень, ступенька
басым - давление, напор
батыр - герой, богатырь
башак - колос, пойло
башка - другой, иной
башлы - умный, способный
башта - сначала, сперва
баягы - недавний, давешний
беләү - оселок, бритвы
беләк - плеча, кисти
белән - со, вместе
белем - знание, познание
белән - со, вместе
бәлеш - бэлеш, нацииональное
берүк - обязательно, умоляю
берәү - кто-то, некий
берәр - одному, какой-нибудь
бераз - немного, несколько
бергә - вместе, совместно
берек - объединение, союз
берле - единица, отметка
берни - ничто, ничего
берсе - кто-нибудь, кто-то
бетле - вшивый
бетте - конец, кончено
бетчә - прыщ, угорь
бибек - чибис, пигалица
биетү - понуд, проучить
бизәү - красить, разрисовывать
бизәк - узор, отделка
бикле - запертый, замкнутый
бикрә - осётр
биләү - биләүсә
биләм - болтаться, шататься
билге - метка, пометка
билле - сшитая, талию
бирән - обжора, чревоугодник
бирге - ближний, близлежащий
бирем - задание
бирле - с тех пор
бирнә - подарок, жениху
бистә - слобода, пригород
битәр - больше
бишәү - пятеро
бишек - колыбель, люлька
бишле - пятилинейный, лампе
биюче - танцор, плясун
боҗра - кольцо, кольцевой
боҗыр - рябчик
богау - прям, перен
богыл - сена
бодай - пшеница, пшеничный
боегу - унывать, печалиться
боеру - приказывать, приказать
божан - шершень
бозау - телёнок, перен
бозлы - ледяной, градовый
бозык - перен, испорченный
болай - таким, образом
болак - ручей, ручеёк
болан - олень, олений
болын - луговой
болыт - туча, облако
борай - полба, полбенный
борау - бурав, сверло
борма - излучина, изгиб
борча - блоха, блошиный
борын - человека, животных
борыс - брус, брусок
борыч - перец, перцовый
ботак - ветвь, ветка
ботау - обрубать, обрубить
ботка - каша
бохар - бухарский
бугаз - горло, гортань
бугай - кажется, будто
буена - буенча
буйлы - полосатый, полосками
букча - сумка, ранец
булат - булат, булатный
буран - буран, метель
бурау - рубить, срубать
бурка - бурка, одежда
бурлы - чалый, гнедочалый
бурсу - преть, начинать
бурыч - долг, задолженность
бурят - бурят, бурятский
бутау - мешать, помешать
бушаю - ослабевать, ослабеть
бушка - попусту, впустую
буылу - страд, душиться
буялу - страд, пачкаться
буяну - краситься, покраситься
быргы - труба, горн
вәзир - визирь, министр
вәкил - представитель, поверенный
вәхши - дикий, дикарь
вөҗүд - существование, бытие
вагаю - мельчать, умельчаться
вакыт - время, пора
варис - наследник, преемник
ватан - родина, отечество
ватык - разбитый, битый
вафат - кончина, смерть
гүзәл - красивый, прекрасный
гүләү - гүелдәү
гүяки - будто, будто
гәрчә - хоть
гәудә - туловище, тело
гөблә - үләң, бете
гөләп - гөлҗимеш
гөман - предположение, гипотеза
гөмбә - молочница, головня
гөнаһ - грех
гөслә - гусли, гуслярный
гаҗәп - изумительный, удивительный
гаҗиз - бессильный, немощный
гавам - народ, масса
гадәт - привычка, навык
гадел - справедливый, честный
газап - мучение, страдание
газиз - дорогой, милый
газлы - газовый, газированный
гаилә - семья, семейство
гайре - иной, другой
гакыл - ум
галәм - вселенная, космос
галим - учёный
гамәл - дело, действие
гарәп - арабский
гарип - калека, инвалид
гасыр - столетие
гауга - галдёж, раздор
гафил - невнимательный, небрежный
гаярь - храбрый, смелый
гаять - очень, весьма
герле - гиревой
гидай - бедняк, бедный
гозер - мольба, просьба
гомер - жизнь, жизненный
горур - гордый, горделивый
дүдәк - дрофа
дәвам - продолжение, дәвамында
дәвер - эпоха, период
дәлил - доказательство, аргумент
дәлия - георгин
дәрес - урок, занятие
дәрья - широкая, перен
дөңья - свет, вселенная
дөмбе - ботало
дөрес - верный, правильный
давыл - буря, ураган
даган - качели
даими - постоянный, неизменный
даирә - круг, окружность
данлы - знаменитый, известный
даулы - спорный, скандальный
дебет - пуховый
дегет - дёготь, дегтевой
дежур - дежурный, дежурство
диелү - говориться, именоваться
диләр - вводн, говорят
димәк - вводн, следовательно
димче - советчик, уговаривает
динле - религиозный, верующий
динче - служитель, культа
дисбе - тәсбих
дистә - десяток
дорфа - грубый, невежливый
дулау - бушевать, перен
дымлы - влажный, сырой
дымсу - слегка, влажный
егылу - падать, упасть
елгыр - ловкий, подвижный
елдам - ловкий, проворный
елдаш - яшьтәш
еллап - около, года
еллык - годовой, годичный
елмаю - улыбаться, улыбнуться
елсыз - раньше, через
елтыр - блестящий, сверкающий
елышу - подвигаться, подвинуться
ермак - канава, промытая
ертык - рваный, разорванный
ерылу - страд, прорываться
ешлау - уплотнять, уплотнить
ешлык - частота, частота
жикет - жакет
жулау - жужжать, прожужжать
җәһәт - быстро, живо
җәбер - гнёт, угнетение
җәелү - страд, разливаться
җәзбә - циркуль, циркульный
җәйге - летний
җәймә - простыня, раскатка
җәнап - превосходительство
җәпле - имеющий, развилину
җәтмә - перен, сеть
җәяле - лучковый, пила
җөйче - швея, белошвейка
җөмлә - предложение
җаһил - невежественный, двуличный
җавап - ответ, ответный
җайлы - удобный, удобно
җанаш - душечка, душенька
җанлы - прям, перен
җаный - милый, милочка
җария - рабыня, раба
җебек - унылый
җебен - унылый
җелек - костный
җенес - половой, племя
җенле - бешеный, бесноватый
җенси - половой, плотский
җепсә - спица, перекладина
җепшү - подтаивать, подтаять
җефет - супруга, супруг
җиңгә - этногр, старшего
җиңги - этногр, старшего
җиңел - лёгкий, весу
җиңсә - нарукавник, рукав
җиһаз - обстановка, мебель
җигем - упряжка
җидәү - семеро
җизнә - старшей, сестры
җизни - старшей, сестры
җикән - рогоз, камыщ
җиләү - вконец, устать
җиләк - ягода, ягодный
җилән - джилян
җиләс - прохладный, свежий
җилем - клеевой, желатин
җилкә - затылок, затылочный
җилле - ветреный, ветрено
җимеш - плод, фрукт
җимле - имеющий, зерно
җирән - рыжий
җиргә - наземь, вниз
җирдә - умножении, количественных
җирле - местный
җирсү - тосковать, родной
җисем - перен, существо
җитди - серьёзный, серьёзно
җитез - проворный, расторопный
җитен - льняной
җитеш - обеспеченный, зажиточный
җомга - пятница, пятничный
җофар - выхухоль, выхухолевый
җуелу - стираться, стереться
җыелу - страд, собираться
җыену - собираться, собраться
җыеру - морщить, сморщить
җыйма - собирательный
җылым - невод
җырчы - певец, певица
җыючы - сборщик, собиратель
зәһәр - отрава, ядовитый
зәвык - прекрасному, удовольствие
залим - жестокий, бесчеловечный
заман - время, эпоха
зарар - вред, вредность
зарлы - горестный, печальный
зарур - необходимый, нужный
затлы - знатный, знатного
зелпе - жимолость, жимолостный
зиһен - разум, сознание
зирәк - сметливый, смышлёный
зират - кладбище, кладбищенский
зирек - ольха, ольховый
золым - гнёт, ярмо
зурат - продолговатая, кладка
зураю - увеличиваться, увеличиться
иҗади - творческий, созидательный
иңбаш - плечо, плечевой
иңгән - впалый, щёки
иңкәю - наклоняться, наклониться
иңкел - низменный, низменность
иңләү - охватывать, охватить
иңлек - ширина
иңрәү - стонать, стенать
иблис - сатана, дьявол
игүле - возделываемый, земле
иганә - помощь, пособие
игрек - игрек, буква
идарә - управление, управленческий
иенке - поникший, повисший
изүче - угнетатель, эксплуататор
изелү - мяться, измяться
изрәү - прям, перен
икеле - двоякий, двойной
икмәк - хлебный, хлеба
илһам - вдохновение, воодушевление
илаһи - божественный, божество
илдәш - соотечественник, земляк
илерү - вопить, реветь
илтер - смушка, мерлушка
имәнү - вздрогнуть, сильного
имана - подушный, надел
имбир - имбирь, имбирный
имгәк - бремя, обуза
имгеч - присоска, сосочек
имезү - кормить, накормить
имләү - этногр, ворожить
имнәү - имләү
имчәк - женская, грудь
инҗил - евангелие
инҗир - инжир, фига
инәлү - умолять, упрашивать
инәле - игольчатый, игличтый
инану - верить, убеждаться
инкяр - отрицание
иннек - румяна
инсан - человек
инсаф - воспитанность, благовоспитанность
ипләү - приспособляться, приспособиться
ипләп - удобно, устроиться
ипсез - неудобный, несподручный
иптәш - товарищ, приятель
ирегү - утомляться, утомиться
иренү - лениться, полениться
ирешү - прям, перен
иркәк - самец, мужчина
иркәм - любушка, милушка
иркен - просторный, обширный
ирләр - мужчины, мужской
ирлек - мужество, мужественность
ирнәү - закраина, ободок
ирсәк - похотливая
иртүк - раненько, спозаранку
иртән - утром
исбат - доказательство
исерү - пьянеть, опьянеть
ислам - ислам, исламский
ислах - реформа
иснәү - нюхать, обнюхивать
испан - испанец, испанский
исрәю - тупеть, отупеть
иссез - недушистый, бесчувственный
итенү - рисоваться, кривляться
итләч - мясистый
итсез - постный, худощавый
ифрат - очень, весьма
ихата - изгородь, плетень
ихаха - охо-хо, го-го-го
ихлас - искренность, чистосердечие
ишарә - жест, знак
ишелү - рушиться, рухнуть
ишетү - слышать, услышать
ишкәк - весло, вёсельный
ишкән - витой, браслет
ишкеч - гребной
ишсез - непарный
иярле - осёдланный
иярмә - сопряжённый
ияртү - увлекать, увлечь
иясез - бесхозный, бездомный
йөгән - прям, перен
йөдәү - изводиться, известись
йөзәр - по сто, плавает
йөзек - перстень
йөзем - виноград, виноградный
йөзмә - плавучий, плавающий
йөкле - гружёный, грузом
йөкче - возчик, извозчик
йөрәк - сердце, сердечный
йөреш - ходьба, хождение
йөртү - водить, возить
йогыш - зараза
йозак - замок, замочный
йолку - дёргать, выдёргивать
йолым - выкуп, откуп
йомры - круглый, шарообразный
йомык - закрытый, сомкнутыйЮ
йомыш - поручение, задание
йонлы - покрытый, шерстью
йонча - мятлик, ворс
йончу - утомляться, утомиться
йотым - глоток
күңел - душа, сердце
күбәү - множество, много
күбәк - рукоять, цепа
күбәю - множиться, умножиться
күбек - күбек, национальное
күгән - шарнир, пробой
күзчә - глазок
күкәй - клетка, птиц
күксү - плесневеть, заплесневеть
күкшә - сойка
күләм - объём, перен
күлем - обеденный, перерыв
күмәк - коллективный, общий
күмәч - булочка, булка
күмер - уголь, угольный
күнәү - соглашаться, уступить
күнәк - бурдюк
күнче - кожевенник, специалист
күпер - мостовой
күпкә - надолго, долгое
күпчү - перекисать, перекиснуть
күрән - осока
күрек - красота, краса
күрем - менструация, месячные
күркә - шишка, сосны
күрше - сосед, соседский
күсәк - прям, перен
күчән - кочан, кочерыжка
күчәр - осевой, перен
күчеш - переход
күчмә - движущийся, переходящий
күшәү - жевать, жвачку
күшәк - павильон, беседка
күшәм - жвачка, жвачных
күшек - кресло
кәҗүл - козловая, козловой
кәүсә - ствол, ствольный
кәбап - кебаб, жаркое
кәбен - этногр, кябин
кәвеш - кявуши, национальная
кәйлә - кайло
кәкре - кривой, гнутый
кәләш - невеста, сговорённая
кәлам - речь, слово
кәлтә - ящерица, ящеричный
кәлшә - отава, подсед
кәмит - спектакль, концерт
кәнди - миска
кәпәч - каляпуш, головной
кәрәз - сотовый
кәрлә - карлик, карликовый
кәсеп - занятие, ремесло
кәтүк - катушка, шпуль
кәттә - гордый, важный
кәфен - саван, саванный
кәшеф - открытие, изобретение
көбәк - ствол, ружья
көдрә - кудри, кудрявый
көенү - печалиться, горевать
көенә - көенчә
көзән - хорь, хорёк
көзгә - осени
көзге - зеркало, зеркальный
көздә - осенью
көзен - осенью, осенние
көзли - осень
көйле - мелодичный, напевный
көймә - лодка, шлюпка
көләч - улыбающийся, весёлый
көлеш - всех
көлке - потеха, забава
көлле - всякий, каждый
көлсу - подзолистый
көлтә - сноп
көлчә - лепёшки
көмән - беременность
көмеш - серебро, серебряный
көнче - ревнивый, ревнивец
көпшә - труба, трубка
көрәү - грести, сгрести
көрәк - лопата, лопатка
көрән - коричневый, бурый
көрәш - борьба, сражение
көрәю - тучнеть, становиться
көрпә - отруби, высевки
көрси - кресло, скамья
көтек - куцый, плохой
көхәл - сурьма, сурьмовый
көчәю - усиливаться, усилиться
көчек - щенок
көчкә - насилу
көчле - сильный, сильно
көшел - куча, ворох
каһәр - проклятие, злоба
кабак - тыква, глазное
кабат - вторично, повторно
кабер - могила, могильный
кабих - кабахәт
кабык - корка, раны
кабым - кусок
кавем - родня, племя
кавык - перхоть
кавым - некоторое, время
кавын - дынный
каган - каган
кагаю - вялиться, сушиться
кадәр - вплоть, сколько
кадак - гвоздь, гвоздевой
кадау - колоть, укалывать
кадәр - вплоть, сколько
кадим - старинный, древний
каене - деверь, младший
каеру - отдирать, отодрать
каеры - кайры
казак - казак, казачий
казан - котёл, котельный
казна - казна, казённый
казый - кадий, казий
казык - колышек
кайгы - горе, печаль
кайда - где
кайма - кайма, оторочка
кайне - каене
кайры - корьё, корьевой
кайсы - который, какой
кайту - возвращаться, возвратиться
кайчы - ножницы, стропило
какма - колотушка
каксу - плесневеть, заплесневеть
какча - сухопарый, худощавый
какчы - пастильщик
калҗа - кусок, ломтик
каләм - стальное, птичье
калай - жесть, жестяной
калак - ложка, металлическая
калгу - вздремнуть, дремать
калку - возвышенный, высокий
калош - галоши, галошный
калта - мошна, карман
калым - этногр, калым
калын - толстый, плоских
калып - колодка, обуви
камәр
камау - окружать, окружить
камил - совершенный, безукоризненный
камка - божья, коровка
камса - хамса, камса
камчы - плеть, плётка
камыл - стерня, стернь
камыр - тесто, мучной
камыт - хомут, хомутный
канау - кровоточить, пойти
канлы - сложн, переводится
канун - канон, закон
капка - ворота, калитка
капыл - внезапно, вдруг
карак - жулик, воровской
карап - соответствии, соответственно
карар - решение, постановление
карау - смотреть, посмотреть
караш - взгляд, перен
карга - ворона, вороний
карлы - снежный, снеговой
карта - [къарта], толстая
каршы - противоположный, противолежащий
карый - Корана, наизусть
карын - желудок, желудочный
карыш - пядь, вершок
карья - деревня
касык - паховый
катиб - секретарь
катрә - капля
катык - катык, национального
катыш - перемешанный, смешанный
качак - беженец, беглец
качыр - лошак
качыш - прятки
кашка - звёздочка, белая
кашык - ложка, ложечный
каюлы - простроченный, окаймлённый
кебек - будто, будто
келәм - прям, перен
келәт - амбар, клеть
кемсә - кто-то, человек
керән - хреновый
керәч - фарфор, фаянс
керем - доход, приход
кереш - тетива, лучок
кәрлә - карлик, карликовый
керпе - ежовый
кертү - вводить, ввести
кесәл - кисель, кисельный
кетәк - курятник, птичник
кечек - слабый
кешән - лошади
киңәш - совет, наставление
киңәю - шириться, расширяться
киңсу - широковатый
кибәк - мякина, мякинный
кибән - стоговый
кибер - надменность
кибет - магазин, магазинный
киенү - одеваться, одеться
киерү - вразн, натягивать
кизәк - кизяк, кизяковый
киләп - сновальня, сновалка
килен - сноха, невестка
килеш - падеж, падежный
кимек - мозговая, кость
кинәт - внезапно, вдруг
киная - иносказание, намёк
кипшү - кипшенү
киртү - засекать, засечь
киртә - жердь, изгородь
кисәү - головешка, обгорелое
кисәк - кусок, кусочек
кисәк - кусок, кусочек
кисем - сечение, разрез
кисеп - вырез, продавать
кисеш - драка, резня
кискә - обрубок, кряж
кисмә - разрезной
китән - полотно, полотняный
китап - книга, книжный
китек - отколотый, отломанный
китем - расход
китче - китсәнә
кичен - вечером
кичкә - вечеру, вечер
кичкә - вечеру, вечер
кишер - морковь, морковный
киштә - полка, полочка
коелу - страд, прям
коену - купаться, искупаться
козау - лукошко, кузов
койка - студень, холодец
койма - забор, ограда
койты - плохой, нехороший
колак - ушной, деталь
колан - кулан, дикая
колач - объятие, охват
колга - шест, жердь
колын - жеребёнок, жеребячий
комак - крыса, крысиный
комар - азартная, азарт
комач - кумач, ярко-красная
комлы - песочный, песком
комсу - супесчаный
комык - кумык, кумыкский
кораб - корабль, корабельный
корал - оружие, орудийный
корым - сажа, копоть
корыч - сталь, стальной
косык - блевотина, рвота
котаю - становиться, здоровым
коткы - подстрекательство, провокация
котлы - счастливый, благодатный
котый - шкатулка, ларчик
котып - полюс, полярный
кочак - объятие, охапка
кочау - обнимать, обнять
кошчы - птичник, птичница
коючы - литейщик
куану - радоваться, обрадоваться
кубыз - комуз
кугын - погоня, гонец
куеру - густеть, загустеть
кузак - стручок, стручковый
кузла - козлы, пилки
кузый - ягнёнок, барашек
куйчы - чабан
кулай - удобный, сподручный
кунак - гость, гостевой
кунык - налёт, пыли
куныч - голенище, краги
купшу - слегка, отдираться
купшы - щеголеватый, щегольской
курай - полый, стебель
курку - бояться, трусить
курпы - отава, отавный
курын - зыбка, ловли
курыс - лыковый
кутыр - струп, короста
кушма - смешанный, соединённый
кушуч - пригоршня
куыру - жарить, зажаривать
куышу - бежать, наперегонки
кызау - лукошко, кузов
кызык - интересный, любопытный
кызыл - красный, красный
кыллы - волосяной, струнный
кылый - косой, косоглазый
кылыч - сабля, шашка
кымыз - кумыс, кумысный
кырау - заморозки
кырку - стричь, постричь
кырлы - гранёный
кырпу - опушка, выпушка
кырчы - полевод
кырый - край, закраина
кырык - сорок, сороковой
кырын - набок, набекрень
кырыс - суровый, строгий
кысан - тесный, узкий
кыска - короткий, коротко
кысла - рачий, раковый
кысык - тесный, узкий
кысым - давление, натиск
кысыр - яловая, нежерёбая
кытай - китаец, китайский
кытык - щекотка
кытыр - бугорок, утолщение
кышкы - зимний
кышын - зимой, зимнее
кыялы - скалистый
кяфер - безбожник, гяур
ләңкә - тявкушка
ләүкә - полок, бане
ләүхә - картина, вывеска
ләвәш - лаваш, лепёшка
ләгән - тазик
ләкин - однако, однако
ләтчә - ласка, зверёк
ләхет - могиле, могила
лайла - слизь
лачын - прям, перен
лепкә - родничок, ребёнка
лычма - насквозь, мокрый
мүкле - мшистый
мәңге - вечно, навеки
мәһәр - этногр, калым
мәгәр - лишь, однако
мәзәк - шутка, забава
мәзин - муэдзин, служитель
мәкер - коварство, хитрость
мәкле - маковый, маком
мәнле - порядочный, добропорядочный
мәсәл - басня, басенный
мәчет - мечеть
мөһер - печать
мөһим - важный, значительный
мөгез - рожок
мөдир - заведующий, управляющий
мөшкә - лоток, насыпь
маңка - сопли, перен
маһир - мастер, умелец
мазар - второй, компонент
майлы - масленый, маслом
майчы - торговец, маслом
малай - мальчик, мальчиковый
маллы - имеющий, много
малчы - скотовод, скотник
мамык - 1.хлопок, хлопковый
манчу - макать, макнуть
масаю - кичиться, возгордиться
матәм - траур, скорбь
матдә - филос, материя
матди - филос, материальный
матур - красивый, красиво
матча - матица, балка
махау - проказа, прокажённый
меңәр - тысяче
меңче - тысячник
мәңге - вечно, навеки
миңле - родинкой
микән - ли...
миләш - рябина, рябиновый
милек - собственность, имущество
милли - национальный
мирас - прям, перен
мирза - мурза, мирза
мисал - пример, иллюстрация
мисез - безмозглый, тупой
мичәү - постромки, постромочный
мичкә - бочка, бондарный
мичче - печник
моңаю - унывать, печалиться
моңлы - печальный, грустный
моңсу - грустный, навевающий
мокыт - безмозглый, бестолковый
монда - здесь
морҗа - труба, печная
мохит - среда, окружающая
мулла - мулла, служитель
мунча - банный
мыжык - ворчливый, брюзгливый
нәҗес - нечистый, поганый
нәзек - тонкий, тоненький
нәкыш - узор, орнамент
нәрсә - составе, н?рс?
нәсел - родовой, племя
нәсер - проза, стихах
нәфес - алчность, ненасытность
нәфис - изящный, прелестный
нәшер - издание
нөктә - обида
нөсхә - экземпляр
надан - неграмотный, безграмотный
назлы - нежный, ласковый
намаз - намаз, богослужение
намус - честь, совесть
нарат - сосна, сосновый
нахак - напрасный, несправедливый
начар - плохой, скверный
нечкә - прям, перен
нигез - фундамент, фундаментный
нидән - отчего, почему
нидер - нечто, что-то
низаг - ссора, конфликт
никах - никах, мусульманский
нинди - какой, каков
ниргә - венец, звено
нисби - относительный
нихәл - дела, поживаешь
ничәү - сколько
ничек - каким, образом
ногыт - бобовый
нокта - прям, перен
нугай - ногаец
нукта - недоуздок
нурлы - лучистый, лучезарный
ныклы - крепкий, твёрдый
оҗмах - прям, перен
оерша - комки, комочки
оеткы - закваска, перен
оешма - организация
озату - провожать, проводить
олагу - пропадать, пропасть
олпат - величественный, авторитетный
олтан - подошва, подмётка
онлау - валять, обвалять
ончыл - мучнистый
оныту - забывать, позабыть
орлык - семенной, семя
орчык - веретено, веретённый
орыну - ударять, удариться
орышу - ругать, обругать
остаз - учитель, наставник
откыр - смышлёный, одарённый
отылу - оттыру
охшау - походить, похожим
охшаш - похожий, подобный
очкак - летучий, летучка
очкын - искра, искровой
очкыр - летун, искусно
очкыч - аэроплан, самолёт
очлап - кусками, цугом
очлау - острить, заострять
очлык - наконечник, конечность
очрак - случай
очрау - попадаться, навстречу
очсыз - 1.тупой, незаострённый
очучы - лётчик, авиатор
очыну - летать, махать
очыру - пускать, пустить
ошату - одобрять, одобрить
оялап - em>нар, гнёздами
оялау - гнездиться, гнездо
оялту - стыдить, пристыдить
оялык - гнездовка
оятлы - постыдный, позорный
оячык - ячейка
өелмә - дамба, насыпь
өермә - вихрь, вихревой
өзгеч - выключатель, разъединитель
өзелү - страд, рваться
өзешү - взаимно-совм, перен
өйдәш - соквартирант, сожитель
өйлек - предназначенный, материал
өйсез - бездомный, бесприютный
өләшү - раздавать, раздать
өлгер - расторопный, проворный
өлкән - старший, взрослый
өлкәр - астрон, стожары
өлфәт - дружба, единство
өмәче - участник, коллективной
өммәт - последователь, приверженец
өндәү - уговаривать, агитировать
өргеч - кузнечный
өрелү - страд, надуваться
өреле - наварный, наваристый
өркәк - пугливый
өркәч - верблюда
өрлек - балка, перекладина
өрфия - сетчатое, покрывало
өслек - поверхность, поверхностный
өстәү - добавлять, дополнить
өстәл - настольный
өстән - сверху, перен
өстен - господствующий, доминирующий
өтүче - палильщик
өтелү - страд, обгорать
өткеч - выжигалка
өферү - дуть, дунуть
өчаяк - таган, тренога
өчесе - всех
өчлек - трёшка, тройка
өшәнү - изнуряться, изнуриться
өшетү - обмораживать, отморозить
өянәк - приступ, пароксизм
өянке - ветла, плакучая
пүлән - полено
пәрдә - занавес, занавеска
пөхтә - опрятный, аккуратный
парлы - парный, чётный
парча - узор, развод
патша - прям, перен
пеләш - плешь, лысина
перес - брысь!
пестә - фисташка, фисташковый
печән - сенной, сенокос
пычак - ножевой, перен
пычкы - пила, инструмент
пышын - тихо, шёпотом
пыяла - стекло, стеклянный
рәвеш - образ, облик
рәнҗү - сильно, обидеться
рәсүл - посланник, пророк
рәсем - рисунок, картина
рәсми - официальный, официально
рәткә - подряд
рәтле - толковый, путный
рәхәт - наслаждение, блаженство
рәхим - милость, милосердие
рашкы - снежная, крупа
ригая - уважение, почтение
ризык - пища, съедобное
риялы - лицемерный, двуличный
румын - румын, румынский
русча - по-русски
рухлы - воодушевлённый, одухотворённый
сүздә - словах
сүзле - словосочетаниях, соответсвует
сүлле - серозный
сүнек - тусклый, померкший
сүрән - плохо, истопленный
сүсән - тимофеевка, метлица
сүсле - волокнистый
сүтек - распоротый, распоротое
сәҗдә - земной, поклон
сәүдә - торговля, торговый
сәбәп - причина, повод
сәдәп - пуговичка, перламутр
сәләт - способность
сәлам - привет, приветствие
сәмих - камедь
сәнәк - вилы, инструмент
сәрви - жёлтая, акация
сәфәр - поездка, путешествие
сәхнә - сцена, сценический
сәхрә - пустыня, поле
сәяси - политический
сөңге - копьё
сөаль - вопрос
сөенү - радоваться
сөзәк - пологий, отлогий
сөзмә - сюзьма, национальное
сөлге - полотенце, полотенечный
сөлек - пиявка, пиявочный
сөрән - этногр, конные
сөрем - копоть, перен
сөреш - течение, направление
сөрмә - сурьма, сурьмяный
сөрсү - протухать
сөртү - вытирать, обтереть
сөтле - молочный, удойливый
сөтче - молочница
сөюче - любящий, любитель
сөялү - прислоняться, облокотиться
саңак - жабра, жаберный
сабак - учёба, обучение
сабан - плуговой, пахота
сабый - прям, перен
сабын - мыльный, мыловаренный
сабыр - терпеливый, выдержанный
савап - благодеяние, вознаграждение
савым - удой, надой
савыр - лошади, кожа
савыт - посуда, сосуд
сагаю - настораживать
сагыз - сера, живица
сагыш - тоска, грусть
саегу - мелеть, обмельчать
сазау - старых, девах
сазлы - болотистый, заболоченный
сакал - борода
сакау - картавый, косноязычный
сакчы - сторож, страж
салам - солома, соломенный
салат - солод, солодовый
саллы - тяжёлый, увесистый
салма - салма, клёцки
салпы - обвислый, опущенный
салчы - плотогон, сплавщик
салым - налог, подать
санау - считать, счесть
санлы - численный, числовой
сарай - дворец, хоромы
саран - скупой, прижимистый
сарку - сочиться, просочиться
сарут - пырей
сарык - овечий, перен
сарыф - расход, трата
сасык - вонючка
саумы - здравствуйте
сауры - кожа, выделанная
сеңел - младшая, сестра
сеңер - сухожилие
селкү - отряхивать, отряхнуть
селте - щёлочь, щелочной
серкә - уксус, уксусная
серле - таинственный, загадочный
сигез - восемь, сложн
сидек - мочевой
сизем - чутьё
симез - жирный, тучный
сирәк - редкий, редко
сирпү - слегка, метнуть
сихәт - полезное, свойство
сихер - прям, перен
сихри - сихерле
соңгы - последний, последнее
солых - мирный
сорау - спрашивать, спросить
соскы - совок, совковый
субай - свайный
суган - луковый
сугым - убойный, забой
сугыш - война, военный
суешу - резаться
сузан - долговязый, длинный
сузаю - удлиняться, расти
сузык - гласный
сукыр - прям, перен
сулау - увлажнять, смочить
сулга - налево, влево
сулда - налево, влево
сулык - водоём
сулыш - прям, перен
сумса - сумса, национальное
сунар - охота
сурәт - изображение, рисунок
сусар - куница, куний
сусау - прям, перен
сусыз - безводный
сусыл - сочный, водянистый
сусын - жажда
сутлы - вязкий, жирный
суыну - прям, перен
суыру - веять, провеять
суыту - прям, перен
сыңар - единственный, перен
сыену - льнут, прильнуть
сыеру - сыдыру
сыешу - умещаться, вместиться
сызгы - чертилка
сызма - эскиз
сызык - черта, линия
сызым - чертёж, чертёжный
сылау - мазать, обмазывать
сымак - подобно, сочетании
сыман - подобно, сочетании
сынау - испытывать, пробовать
сынык - сломанный, обломок
сыныш - преломление
сырга - серёжка, соцветие
сырлы - резной, рифлёный
сырма - стёганый, стёганая
сыткы - прыщ, угорь
сытык - раздавленный, смятый
түбән - низкий, низко
түгел - только
түзем - түземле, түземлек
түләү - платить, оплачивать
түтәй - тётя, тётка
түтәл - гряда, грядка
түшәү - стлать, расстилать
түшәк - перина
түшәм - прям, перен
тәҗел - срочный, спешный
тәңкә - монета, рубль
тәңре - всевышний
тәүбә - раскаяние, покаяние
тәүге - первый, изначальный
тәгам - пища, яства
тәмам - предик, конец
тәмгы - алчность
тәмле - вкусный, вкусно
тәмуг - прям, перен
тәпән - небольшая, кадка
тәпәч - дубинка, палка
тәрәт - экскременты
тәрәч - треска, тресковый
тәртә - оглобля
тәтәй - старшая, сестра
тәхет - трон, престол
төбәү - целить, прицелиться
төбәк - край, сторона
төгәл - точный, точно
төдәш - однородный
төзәү - целить, наводить
төзәю - выпрямляться, распрямиться
төзек - исправный, благоустроенный
төймә - пуговица, пуговка
төкле - волосатый, пушистый
төксе - мрачный, сумрачный
төкчә - волосок, ворсинка
төлке - прям, перен
төмән - десять, тысяч
төнәү - настояться
төнге - ночной
төнен - ночью
төнлә - ночью
төпке - глубинный, нижний
төпле - пнистый, перен
төпсә - пенёк, корешок
төптә - вводн, основном
төпчү - разбирать, расспрашивать
төрән - лемех, сошник
төрбә - склеп, усыпальница
төрек - турок, турецкий
төрем - завёртка, обёрточный
төрки - тюркский, тюрки
төрле - разный, разнообразный
төрмә - тюрьма, тюремный
төрпе - прям, перен
төртү - тыкать, толкать
төрчә - подвид, подкласс
төсле - цветной, похоже
төтәү - дымить, коптить
төтен - дымовой, дымок
төшем - прибыль, выручка
төшке - полуденный, обеденный
төшмә - нисходящий
төялү - грузиться, набиваться
төянү - грузиться
таҗик - таджик, таджикский
таҗлы - венценосный
табак - большая чаша
табан - стопа, ступня
табиб - врач, лекарь
табут - гробовой
табын - стол, накрытый
табыр - табор
табыш - находка, прибыль
тавис - павлин, павлиний
тавык - курица, куриный
тавыш - голос, голосовой
таган - таган, таганок
тагын - опять
таифә - группа, племя
такта - доска, дощатый
такыр - ровный, укатанный
такыя - скуфья, такия
таләп - требование, притязание
талак - развод, расторжение
талау - грабить, ограбление
талаш - ссора, скандал
талку - мять, трепать
тамак - горло, глотка
таман - предик, спору
тамга - знак, метка
тамчы - капля, капель
тамыр - прям, перен
танау - ноздря, животных
танык - свидетель
таныш - знакомый, знакомый
таплы - прям, перен
тарак - гребень, расчёска
тарау - чесать, лён
тараф - сторона
тараю - суживаться, затрудняться
тарих - история, исторический
тарту - тянуть, себе
тасма - лента, тесьма
татар - татарин, татарский
татлы - прям, перен
татым - привкус
таулы - гористый, холмистый
ташлы - каменистый
ташчы - каменщик, каменотёс
таяну - опираться, облокотиться
тезем - цепь, цепочка
тезмә - цепь, цепочка
текмә - частокол
теләү - желать, хотеть
теләк - желание, охота
теләп - охотно, желанием
телем - ломоть, ломтик
телле - языкастый, острый
телче - языковед, лингвист
тентү - обыскивать, обыск
терәү - прям, перен
терәк - подпора, подставка
терәп - вплотную
тешле - зубчатый, перен
тибеш - биение, толчок
тигез - ровный, ровно
тизәк - помёт, экскременты
тиккә - даром, бесплатно
тикмә - пустой, простой
тимер - железо, железный
тирәк - тополь, осокорь
тирән - глубокий, глубоко
тирес - навоз, навозный
тирле - потный
тирмә - юрта
титак - хромой
тишек - дыра, отверстие
тоҗым - паутина, паутинка
тоелу - чувствоваться, ощущаться
тозак - силок, прям
тозлы - солёный, пересоленный
тойгы - ощущение, чутьё
токым - порода, потомство
толып - тулуп, тулупный
томан - туман
томау - насморк, насморочный
тонык - прозрачный, чистый
торак - жилище, жилой
торба - труба
торма - редька
торна - журавль, журавлиный
торыш - положение, состояние
тотам - пучок, ладонь
тоташ - сплошной, сплошь
тотка - ручка, рукоятка
тотык - заложник
тотым
тотыш - поведение, манера
туару - распрягать
тубал - лукошко, кузов
тубык - щиколотка
тубыр - желвак, животных
тугай - извив, излучина
туган - прям, перен
тугаю - насыщаться, созревать
тугыз - девять, сложн
тугым - ободочный
туену - питаться, кормиться
тузан - пылевой, пыльца
тузгу - взлохмачиваться, растрепаться
туйра - дубок, молодой
тукта - предик, хватит
тулай - общий, валовой
тулма - голубцы, блюдо
тунау - обдирать, сдирать
тупас - грубый, грубо
тупса - шарнир, дверная
тупчы - артиллерист
тупый - тупоносый, тупым
тупыл - тополь, тополиный
турам - ломоть
турау - нарезать, разрезать
тураю - выпрямляться
турта - накипь, варке
турун
туташ - обращение, незамужней
тутый - прям, перен
тутык - ржавчина, ржавый
туфан - всемирный, потоп
тыңчы - лазутчик, шпион
тыгыз - тесный, тесно
тыгын - тесный
тыелу - запрещаться, воздерживаться
тынгы - покой, спокойствие
тынчу - затхлый, спёртый
тыныч - спокойный, тихий
тыныш - дыхание, пауза
тырма - грабли, борона
тырпы - ощетинившийся, взъерошенный
тырыс - туес, туесок
тырыш - старательный, усердный 
тышка - наружу
тышкы - прям, перен
тышта - снаружи, извне
тышча - оболочка
уңган - дельный, деловитый
уңнан - справа
убылу - проваливаться, обваливаться
уелма - выем, выемка
уелыш - разрез
уенчы - игрок, музыкант
узган - минувший, истёкший
узыну - зазнаваться, выходить
узышу - состязаться, гонке
уйгыч - резак
уйлау - думать, размышлять
уймак - напёрсток
уйнак - игривый, резвый
уйнап - шутку
уйнау - прям, перен
уйнаш - прелюбодеяние, разврат
уйсыз - бездумный, беспечный
уйчан - задумчивый, задумчиво
укалы - вышитый, канителью
уклау - скалка
укмаш - скомканный, сбитый
уктай - стрелой
укучы - ученик, учащийся
укыну - читать, себя
укыту - понуд, учить
уллык - сыновний
умыру - отламывать, отрывать
унлап - около, десяти
унлык - десятка, десятирублёвый
упкын - пропасть, бездна
ураза - ураза, мусульманский
уралу - мотаться, обмотаться
урама - обмотка, обвязка
урату - понуд, отгараживать
ургыл - быстрина, стремнина
ургыч - жатка, жнейка
урлау - воровать, красть
урман - лесной
уртак - общий, совместный
утлау - выгон, выгул
утлык - ясли, кормушка
утрак - оседлый
утрау - остров, островной
утыру - садиться, сидеть
учлам - клок, горсть
учлап - пригоршнями, горстями
учлау - зажать
үбешү - целоваться
үзара - между, собой
үзбәк - узбек, узбекский
үзбаш - самостоятельно, самостоятельный
үзлек - свойство
үкенү - каяться, сожалеть
үкерү - реветь, завывать
үксез - сирота, сиротский
үлүче - умирающий, смертный
үлгән - умерший, мёртвый
үлчәү - мерить, измерять
үлчәм - мера, мерка
үрәчә - грядки, разводы
үрдәк - утиный
үрелү - виться, сплестись
үрләү - взбираться, подниматься
үрнәк - образец, образцовый
үртәү - поддразнивать, дразнить
үрчем - приросток, приращение
үсенү - возгордиться, воображать
үсмер - подросток, отрок
үтенү - просить, упрашивать
үтерү - убивать, умерщвлять
үткән - прошлый, минувший
үткәч - спустя
үткел - перевал
үткен - острый, перен
үткер - үткен
үтләү - объедаться
үтмәс - тупой, неострый
үчегү - таить, злобу
фәһем - интеллект, разум
фәләк - небосвод, судьба
фәлән - такой-то, некий
фәнни - научный
фәнчә - научному, научно
фәтва - фетва, разрешение
фәхеш - разврат, прелюбодеяние
файда - польза, выгода
факыр - бедняга, бедный
фалчы - гадальщик, ворожей
фараз - предположение, мнение
фарсы - персидский
фарыз - религиозное, предписание
фасыл - время, раздел
фатир - квартира, квартирный
фахиш - развратный, распутный
фетнә - мятеж, бунт
фидия - фидия, пожертвование
фикер - мысль, намерение
фикри - мыслительный, умственный
филтә - фитиль
фирка - группа, секта
фытыр - фытыр, подаяние
хәбәр - весть, известие
хәвеф - опасность, угроза
хәзер - сейчас, теперь
хәйлә - хитрость, лукавство
хәләл - дозволенный, разрешённый
хәлвә - халва, халвовый
хәлдә - в силе
хәлле - сильный, здоровый
хәлфә - учитель, наставник
хәлчә - возможности
хәмер - алкоголь, спиртное
хәрәм - запретный, запрещённый
хәрби - военный, воинский
хәреф - буква, шрифт
хәстә - болезнь, больной
хәтәр - опасный, опасность
хәтер - память, хәтердә
хәтле - до тех пор
хәтта - даже
хәтфә - бархат, бархатный
хөкем - судебный, приговор
хөрмә - финик, финики
хөрти - предик, плохой
хөсет - зависть
хөтбә - проповедь, хутба
хаҗәт - нужда, надобность
хаким - повелитель, властелин
хаклы - имеющий, право
хакта
халәт - состояние
халык - народ, народный
ханым - госпожа, дама
харап - предик, страх
хатын - женщина, жена
хикәя - рассказ, повествование
хилаф - противный, противоречащий
хирыс - пристрастный, охочий
хисап - счёт, число
хисле - чувствительный, эмоциональный
ходай - господь, божий
хозур - веселье, весёлый
хокук - право, правовой
холык - характер
хонса - гермафродит, обоеполый
һәвәс - страсть, желание
һәлак - гибель, смерть
һәммә - весь, каждый
һөҗүм - нападение, набег
һөнәр - ремесло, профессия
һаман - время, всегда
һични - һичнәрсә
чүбек - очёски, охлопок
чүгәү - чүгәләү, становиться
чүкеч - молоток, молот
чүмеч - половник, черпак
чүпле - сорный, засорённый
чүпрә - дрожжи, закваска
чәүкә - галка, галочный
чәйче - чаевод, чаёвник
чәкән - початок, вышивки
чәмчә - кайма
чәнчү - колоть, вколоть
чәпчү - расплескаться, перен
чәчәк - цвет, цветок
чәчән - народный, певец
чәчмә - прозаический
чәшке - норка, норковый
чөлли - четверть, четвертушка
чөнки - потому
чаңгы - лыжный
чабак - плотва, сорожка
чабар - гонец
чабыш - бега, скачки
чагым - искра, искровой
чагыр - пестроглазый
чаклы - величиной
чакма - огниво, кресало
чакта - когда
чалгы - коса
чалым - сходство, черты
чалыш - кривой, косой
чапкы - сечка, тяпка
чарык - колесо, мельничное
чарыс - резвый, лошади
чатак - неправильный, ненормальный
чатан - хромой, хромец
чаткы - искра, искровой
чатма - парча, парчовый
чатыр - шатёр, шатровый
чачак - бахрома, кисточка
чебен - мушиный, детская
чебеш - перен, замухрышка
чегән - цыган, цыганский
челән - цапля, перен
челлә - жаркая, перен
черек - гнилой, гниль
черем - дрёма, дремота
черки - комар, комариный
чибәр - красивый, красиво
чигеш - вышивка
чикле - ограниченный, имеющий
чиләк - ведро, ведёрный
чимал - сырьё, сырьевой
чинау - визжать, пищать
чирәм - трава, лужайка
чирәп - черепица, черепичный
чирак - скрученный, туго
чират - очередь, черёд
чирау - покрываться, тонким
чирек - четверть, четвёртая
чирле - хворый, больной
чиста - чистый, опрятный
читән - плетень, изгородь
читек - ичиги, сафьяновые
читән - плетень, изгородь
чишмә - родник, родниковый
чияли - глухим, узлом
чокыр - рытвина, воронка
чолан - сени, чулан
чолык - борть, бортевой
чорма - чердак, подволока
чуалу - путаться, запутываться
чукыр - клест, клёстовый
чулак - сухорукий, однорукий
чулпы - этногр, накосник
чуман - короб
чумар - клёцки, клёцками
чучка - хрюшка, свинья
чыбык - прут, прутяной
чыгым - расход, затрата
чыгыр - блочный, колесо
чыгыш - выступление, выходка
чыдам - стойкий, упорный
чыдау - терпеть, вытерпеть
чыклы - росистый
чынга - всерьёз
чыпта - рогожа, рогожка
чырай - лицо, мина
чыршы - еловый
чытыр - хворост, хворостяной
шәңгә - шаньга, шанежка
шәүлә - 1.блик, отсвет
шәһәр - город, городской
шәбәю - усиливаться, улучшаться
шәраб - винный
шәхес - лицо, особа
шәхси - личный, индивидуальный
шөбһә - сомнение, подозрение
шөпшә - осиный
шөреп - шуруп, шурупный
шаһит - свидетель, очевидец
шадра - рябой, щербатый
шакшы - грязный, нечистоплотный
шаулы - бурный, шумный
шаяру - шалить, озорничать
шаять - вводн, наверно
шелтә - упрёк, выговор
шикәр - сахар, сахарный
шикле - подозрительный, сомнительный
шикмә - решетина, обрешетина
шимбә - суббота, субботний
шомлы - таинственный, страшный
шулай - правильно, вводн
шулпа - бульон, бульонный
шунда - тогда, заключается
шуышу - ползать, скользить
шыңшу - скулить, визжать
шыбын - шомпол
шымчы - сыщик, лазутчик
шырпы - спичка, спичечный
шытым - росток, всходы
ыһһем - звукоподражание, кашлю
ызгыш - ссора, дрязги
ымлау - подавать, знаки
ымлык - междометие
ымсыз - молча, молчаливый
ындыр - гумно, рига
ыргак - крюк, зацепка
ыргым - спорт, рывок
ыржык - нескромно, улыбающийся
ырмау - выем, выемка
ыслау - окуривать, прокуривать
ыспай - аккуратный, опрятный
ышану - верить, веровать
ыштан - штаны, кальсоны
ыштыр - портянка, онуча
эңгер - эңгер-меңгер
эзләү - искать, разыскивать
эзсез - вести, бесследно
элүле - развешанный, повешенный
эләгү - цепляться, зацепиться
элгәр - предшественник
элгеч - вешалка, крюк
элмәк - петля, петелька
энәле - иглистый, игольчатый
эремә - раствор
эретү - плавить, таять
эрләү - прясть, напрясть
эрләм - пряжа
эскәк - пинцет, щипчики
этәрү - отталкивать, отстранять
этенү - толкаться
этешү - толкаться, многих
этләү - измаять, измучить
этлек - подвох, подлость
эчерү - поить, напоить
эчләү - подшивать, подкладку
эчлек - подкладка
эчтәң - изнутри, эченнән
эшерү - задвигать
эшләү - работать, трудиться
эшсез - бездельник, лентяй
эшчән - работящий, трудолюбивый
юалык - место, растёт
юанаю - толстеть
юаныч - утешение, забава
юашаю - юашлану
югалу - теряться, утеряться
югары - высокий, высоко
юкару - утончаться, тончать
юклык - неимение, отсутствие
юксыл - бедный, неимущий
юлдаш - спутник, попутчик
юллау - отправлять, направлять
юллык - предназначенный, дороги
юлыгу - натыкаться, встречать
юмарт - щедрый
юнәлү - направляться, взять
юнәтү - исправлять, поправлять
юнучы - тесальщик
юньле - порядочный, толковый
юрган - одеяло, одеяльный
юртак - рысак, рысистый
юртыш - аллюр
юшкын - накипь, осадок
юырту - бежать, рысью
яңару - обновляться, подновиться
яңача - по-новому
яңгыр - прям, перен
яһүди - еврейский
ябага - шерсть-линька, линька
ябулы - крытый, накрытый
ябыгу - худеть, истощать
ябылу - страд, закрываться
ябыну - накрываться, одеялом
ябышу - липнуть, прилепляться
ягъни - то есть
ягылу - страд, мазать
ягыну - намазываться
ядкәр - памятник, исторический
язлый - весной
язмыш - судьба, доля
язулы - записью, исписанный
язучы - писатель, писательский
язылу - записываться, запись
язышу - переписываться, переписка
яклау - защищать, защита
якташ - земляк
ялану - облизываться
ялгам - привой, прививок
ялган - ложный, лживый
ялгау - присоединять, присоединение
ялгыз - одинокий, одиноко
ялгыш - ошибка, оплошность
ялкау - ленивый, лениво
ялкын - пламя, перен
яллау - нанимать, вербовать
ялмау - прям, перен
ялтыр - блестящий, сверкающий
ялыгу - утомляться, утомление
ялыну - упрашивать, умолять
ямалу - страд, заживать
ямьле - красивый, живописный
янәсе - вводн, якобы
янәшә - рядом, смежный
янгын - пожар, пожарный
яннан - сбоку
янтаю - крениться, наклоняться
янтык - боковой, кособокий
янчык - кошелёк
янына - рядом
яньчү - мять, расплющить
ярәшү - помолвить
яралу - зарождаться, зарождение
яралы - раненый
ярату - любить, полюбить
ярашу - приспосабливаться, соответствовать
ярдәм - помощь, подмога
ярлык - ярлык, ханская
ярпач - хвастливый, бахвал
ярпаю - бахвалиться, хвастаться
ярсып - разъярённо, возбуждённо
ярчык - осколок
ярылу - понуд, раскалываться
ярышу - соревноваться, состязаться
ясалу - страд, образовываться
ясану - наряжаться, прихорашиваться
ясмин - жасмин, жасминовый
ясмык - чечевица, чечевичный
ястык - перина, перинный
ятимә - девочка-сирота
яткан - лежалый, товар
яткын - залёжный
ятлау - заучивать, наизусть
яттан - наизусть, память
ятышу - идти, лицу
яулау - прям, перен
яулык - платок
яфрак - листовой
яшәеш - бытиё
яшәрү - молодеть, зеленеть
яшерү - прям, перен
яшьле - слезящийся, заплаканный
яшьли - смолоду, очень

